EMS	EMS	中国邮政EMS
STO	STO	申通快递
TTKDEX	TTKDEX	天天快递
YTO	YTO	圆通速递
SF	SF	顺丰速运
YUNDA	YUNDA	韵达快递
ZTO	ZTO	中通速递
LBEX	LBEX	龙邦快递
ZJS	ZJS	宅急送
APEX	APEX	全一快递
HTKY	HTKY	汇通速递
CNMH	CNMH	民航快递
AIRFEX	AIRFEX	亚风速递
CNKJ	CNKJ	快捷速递
DDS	DDS	DDS快递
CYEXP	CYEXP	长宇
CRE	CRE	中铁快运
FEDEX	FEDEX	FedEx
UPS	UPS	UPS
DHL	DHL	DHL
DBL	DBL	德邦物流
POST	POST	邮政平邮
CCES	CCES	CCES
DTW	DTW	大田
YUD	YUD	长发
ANTO	ANTO	安得
HOAU	HOAU	华宇物流
BAM	BAM	平邮